.........................
.........................
BBBBB...B................
............BBB..........
.................B.......
.........................
..............B..........
.........................
....BB....B..............
.........................
.........................
.............B...........
.........................
........BBB..............
...............BBBB......
...BBB...................
.....................BB..
BBBBBBBBBBBBBBBBBBBBBBBBB